.d=17
.t=200
6666666666666666666666666666666666666666
6555555555455355555535355555555555355556
6553235555555555555555345535555555555556
6555555555555555555553535535555555355556
6355555555555553555555355355553553555556
6355335555555553355555555555355555353556
6555535535555555535555535535555555353356
6111111111111111111111111111111555355356
6555553554555535355555555554535555555356
6555555553555555555555553553554555535556
6553555353555555555555553353553555555556
6555555535555555533555555553553545555556
6535555535555555535345545555355535545356
6543555555555555553335535555555545555536
6555555551111111111111111111111111111116
6555555555555555455553555553555355555556
6355555555553355355555555355555535335586
6535535555555535555535555555455535335556
6555534555555555553555555353455555535556
6555555555353533555555555353455555535536
6545555535555555555555555355355553555356
6666666666666666666666666666666666666666