.d=16
.t=100
6666666666666666666666666666000000000000
6355555555555555555555555536000000000000
6235555555555555555555555386000000000000
6453555555555555555555553546000000000000
6345355555555555555555535436000000000000
6534535555555555555555354356000000000000
6553453555555555555553543556000000000000
6555345355555555555535435556000000000000
6555534535555555555354355556000000000000
6555553453555555553543555556000000000000
6555555345355555535435555556000000000000
6555555534535555354355555556000000000000
6555555553453553543555555556000000000000
6555555555345335435555555556000000000000
6555555555534554355555555556000000000000
6666666666666666666666666666000000000000
0000000000000000000000000000000000000000
0000000000000000000000000000000000000000
0000000000000000000000000000000000000000
0000000000000000000000000000000000000000
0000000000000000000000000000000000000000
0000000000000000000000000000000000000000