.d=140
.t=500
6666666666666666666666666666666666666666
6343434343344334343434334344444343434346
6443434343433344343444334344343434433436
6334433343343444333443434434343434434446
6433344333443544343345343433353433344436
6343434344433434344433434344433434434346
6334343453343333443434343443434334343346
6344344343444344435433335334343443434436
6433433433334353444434334344344434344346
6434334354443343333444334343433343434346
6431111111511111343434311111115111111436
6431000000000001434534310000000000001346
6331028000000001343333310000000000001436
6431000000000001443434410000000000001436
6431000000000001343344310000000000001446
6431000000000001344333410000000000001346
6341000000000001111111110000000000001436
6431000000000000000000000000000000001346
6341000000000001553435410000000000001436
6431000000000001344334310000000000001446
6431111111111111343334411111111111111346
6666666666666666666666666666666666666666