.d=12
.t=400
6666666666666666666666666666666666666666
6555555555555255555555555555555555555556
6111111111111511111111555555555555555556
6155554555555555555541555555555555555556
6151015111111011111151555555555555555556
6151715145555555554151555555555555555556
6151715151111011115151555555555555555556
6151715151455555415151555555555555555556
6151715151511011515151555555555555555556
6151717171710001717171555555555555555556
6151710101017771010101555555555555555556
6151710101010001010101555555555555555556
6151715151511111515151555555555555555556
6151715151455555415151555555555555555556
6151415151111111115151555555555555555556
6151415145555555554151555555555555555556
6151415111111111111151555555555555555556
6151414555555555555541555555555555555556
6111111111111111111111555555555555555556
6555555555555555555555555555555555555556
6555555555555555555555555555555555555586
6666666666666666666666666666666666666666