.d=6
.t=400
6666666666666666666666666666666666666666
6535355535551355355554551535555355355056
6535545555351555553555551555345555535356
6555355555531553535555551355553533555336
6350555535551555530553551553555353555556
6535535553551055553505351355355555353536
6553555555551355555553551550553535355516
6555555355351555355355551535355553555556
6355535553531533555555351555553535515356
6555511111111117111111111111111555153556
6533555535555353335535535555553551555356
6555505555355533335354535350535515553556
6353533351555333335555535553535153535536
6535335551355111111111111113351555555556
6555555531555355535355555505515553553556
6335355351535553555553535535155355355536
6555535551553555553555353551555553550556
6553553351355355335535355515505555555556
6555555531555553533255555535533555353586
6354550551570553535535535550755554555556
6553553551533535553553553555355355535536
6666666666666666666666666666666666666666