.d=19
.t=500
6666666666666666666666666666666666666666
6350555335555535055355555335535533555436
6555554535555555355553555355553555535536
6555555534153515501555155555555005555356
6411111111111515551553155305555075555556
6355555555155515351045155555555555430556
6335535555155515551550133555555355355556
6553555553133515551553133555535555554536
6511111111111515351053153555355075555356
6353555555155515351553153553555005505556
6535555555130015541553155555555555435356
6055555555133315531535155555555535553556
6511111111111111131555155345555555555556
6555350555155513551355155555555075355556
6555503355155515551455155555555005555556
6555535355154515531535155355355555555546
6511111111111515551555155305555555550556
6553555555153515551353155555555555550056
6352555350155515551353155535555545553556
6555535555153514551555155355550554555556
6335555555153514551555155555454555535586
6666666666666666666666666666666666666666