.d=13
.t=100
6666666666666666666000000000000000000000
6000000002000000006000000000000000000000
6000000000000000006000000000000000000000
6000000000000000006000000000000000000000
6000000000000000006000000000000000000000
6000000000000000086000000000000000000000
6000000000000007776000000000000000000000
6000000000000077776000000000000000000000
6000000000000077776000000000000000000000
6444444444444477776000000000000000000000
6666666666666666666000000000000000000000
0000000000000000000000000000000000000000
0000000000000000000000000000000000000000
0000000000000000000000000000000000000000
0000000000000000000000000000000000000000
0000000000000000000000000000000000000000
0000000000000000000000000000000000000000
0000000000000000000000000000000000000000
0000000000000000000000000000000000000000
0000000000000000000000000000000000000000
0000000000000000000000000000000000000000
0000000000000000000000000000000000000000