.d=60
.t=400
6666666666666666666666666666666666666666
6355555558555555352355555335535533555536
6553555553555555555555355355553555535536
6553555555353555555355555555555535555356
6555555555555555355553555355553555555556
6555555553555553555535555555555555535556
6553555535555555553555555555555555355556
6555535555535555555555535555535555555536
6555555355555555555553555355355553555356
6555555555555533555555555553555555535556
6355555355555555555535555555555555555356
6555353555555555355355555555555535553556
6555555553555355555355555555555555555556
6553555555555555555555555555555555355556
6555555553555535355555355555555355555536
6555535555555355555355555355555355555556
6553511111111111111111111111111111155556
6553599999999999999999999999999999955556
6355533333333333333333333333333333353556
6555555555555555555555555555555555555556
6535555555555555555555555555555555535556
6666666666666666666666666666666666666666