.d=30
.t=400
6666666666666666666666666666666666666666
6555555555555555555555555555555555555586
6525555555555555555555555555555555555556
6555555555555555555595959595959555555556
6555555555555555555535353535353555555556
6555555555555555555555555555555555555556
6555555555555555555555555555555555555556
6555555555555555555555555555555555555556
6555555555555555555555555555555555555556
6555550505050505055555555555555555555556
6555550505050505055555555555555555555556
6555550505050505055555555555555555555556
6555550505050505055555555555555555555556
6555550505050505055555555555555555555556
6555550505050505055555555555555555555556
6555550505050505055555555555555555555556
6555550505050505055555555555555555555556
6555550505050505055555555555555555555556
6555550505050505055555555555555555555556
6555559595959595955555555555555555555556
6555555555555555555555555555555555555556
6666666666666666666666666666666666666666