.d=20
.t=300
6666666666666666666666666666666666666666
6055350305353355552535530535550505530356
6310555335555539353553051535055555353506
6351333530355550535503310030005005555006
6553153555553505335055103553333533055006
6335515535555535553551553535535555550006
6535531555905550535313555555335555555336
6030053135335305355155553550555553553536
6533535515533535501033555555050553533556
6355035551555555319353035505550555333556
6305355555155303103355355535503533555536
6335355355315551355355503553533555500556
6355535335355553535533505055555355533536
6350555553351115555555030353355533353356
6535555333355555053355533355555553553356
6550533355505505355535033533553553553336
6335955550503355555035333553555555505556
6555053350533553555353535505053355550556
6535533559055535535535535533305335355536
6535055533505533555530055535355353535056
6553533353500035558555355535503535353336
6666666666666666666666666666666666666666