.d=2
.t=300
6666666666666666666666666666666666666666
6255555355555355553555355555355553555586
6555355555555555555553555335555535535556
6355553555355553555355555555555555555556
6555355555555355553535535555555535355356
6555555553355555555535535555553555555556
6553553553353555355555535555555555535556
6535555555555555355535555555555535555556
6553555111111551111115553555535555555356
6555553155551531555513355355553555553556
6555355153551351555315555555555553555556
6555555155551551535515553553535555555536
6535535134551551554515555555555555555556
6553555155551551555515355555555535535356
6555555155531531355515555555555555555536
6555555111111551111115535535555555553556
6553555555555555555555555535555355555556
6355535535555555355553555555355350535556
6335555350055535500555555005535550755556
6335555557055555507355333075555553055536
6355335535555355355535555535555535553536
6666666666666666666666666666666666666666