.d=19
.t=300
6666666666666666666666666666666666666666
6555555315453055155575551555555515555546
6535555515505555155533051555550513330556
6555555515505505155535451050505515555556
6000000000300000000000300304030000300006
6350034515555533153505551553555515353356
6555355315555555155505351355555515354356
6111111111111111111101111111111111111116
6505553510505535155505551550530515555056
6550505514550550155505551000550015505556
6004000003003000000000000043004000030006
6505505515555555133005551553553515555056
6535505515005555135005541555055515545356
6543555515555545153305531500700015555536
6111111111111111111101111111111111111116
6005555515550555155503551553555315555556
6005505515550055155505551055555510055556
6330040000003300000000000300000000330006
6555534510555555103505551353455515535586
6555055013553533102505551353455515535536
6545555315555055153505501355355513555356
6666666666666666666666666666666666666666
