.d=52
.t=300
6666666666666666666666666666666666666666
6535555533333455555555305555555555344446
6325530045553335555555351555555555344446
6555341055555555555555551555555555333336
6111111155355555355555331111555555555556
6834444153435543433335331431555555555556
6553444111111114111111111331555555555556
6533344155555553555555555551555555555556
6553334155155555555543555551535555555556
6555553455155555555553555551435555555536
6555555155155555555555555551335555555336
6555555153455555555554445551335555553336
6555555155155555555555555554435555533336
6355555111155555555555555551535555333336
6335555144444445555555555551535555553346
6114111155155555555553555555535555555336
6554555535155555555553355551535555555536
6554555503555555555553435551535555555556
6535555555135555555553333551535355555556
6435533555133555555553333351533335555556
6435553555133355554003333331445555355556
6666666666666666666666666666666666666666