.d=1
.t=300
6666666666666666666666666666666666666666
6855555555551455555555555555555555555556
6555555555551111111111111111111111111156
6111111155553555555555555555555555555156
6555555155551511111111111111111111115156
6511115155551515555555555555555555515156
6515515111101515111111111111111111515156
6515515555555515133555555555555551515156
6515511111111115155555555555555551515156
6515515555555555155111111111111551515156
6515515111111111155155555555551551515156
6515515155555555555151111111151551515156
6535555151111111111151312555551551515156
6515111151555555555551511111111551515156
6515155551555555555555555555555551515156
6515155551111111111111111111111111515156
6515155555555555555555555555555555515156
6515111111111111111111111111111111115156
6515555555555555555555555555555555555156
6511111111111111111111131111111111111156
6555555555555555555555555555555555555556
6666666666666666666666666666666666666666