.d=99
.t=500
6666666666666666666666666666666666666666
6455454553550344455535535534354343555546
6333553534550333335355535555554353355536
6445553555550555543550035553333353335556
6355533543000545555340543003454553334326
6453111111111111111111111111111111111116
6555143333341343553415444444144433431386
6555154333451555553514333333133444351446
6335155434551555553515555555155533431446
6435135343035555355035555555555555551546
6455155434551453335013555553135555551356
6455154555451533333413355533135555551536
6455145555541333333313334333144555531356
6454111111111111311111113111111151111536
6455134444341333355413333333155545541356
6335133353331333555513333335153355541556
6555155555551355555515335335155335551346
6540300555400305555555555355555334551356
6554130555551553553313555354153333351356
6303145535351553055515355354153333355556
6345154534341453455514455354144555551456
6666666666666666666666666666666666666666