.d=18
.t=300
6666666666666666666666666666666666666666
6555555555555555555555555555555555555556
6511151115111511151115111511151115111156
6514151415141514151415141514151415144156
6515151515151515151515151515151515155156
6515151515151515141514151515151515155156
6515151515151515555555551515151515155156
6515151515151515111115551515151515155156
6515151515151515121815551515151515155156
6515151515151515151515551515151515155156
6515151515151515151515551515151515155156
6515151515151515151515551515151515155156
6515151515151515151515551515151515155156
6515151515151515151515551515151515155156
6530151515151515151515551515151515100356
6515141514151415151515551415141514155156
6515111511151115151515551115111511155156
6515555555555555151515555555555555555156
6511111111111111151511111111111111111156
6555555555555555551555555555555555555556
6555555555555555555555555555555555555556
6666666666666666666666666666666666666666