.d=79
.t=500
6666666666666666666666666666666666666666
6555555355555555555355555553333333334446
6555553335555555555535555555344444444346
6555533333555555555553555555533333333336
6555533333555555555555325555553555555556
6555533833555555555555535555555355555556
6555333333355555553555553555555535555556
6553433333435555553555555355555553555546
6533333333333555553555555555333333355446
6533333333333555553555555555444444434446
6553333333335555553511111111111111111116
6555333333355555553544444444444444444446
6555534443555555553533333333333333333336
6555553435555555553555555555555555333336
6555555355555555553555555555555555533336
6555555555555555553355555555555555555556
6355553555355535553335555355535553555406
6335534353435343554433553435343534353436
6333553555355535534443355355535553555346
6333355555555333334444335555555555555446
6334505554455555554444333555555555555446
6666666666666666666666666666666666666666