.d=161
.t=400
6666666666666666666666666666666666666666
6233333333333333333333333333333333333336
6555545555455554555545555455545555455546
6333333333333333333333333333333333333356
6555545555455554555545555455554555545556
6433333333333333333333333333333333333346
6555545555455554555545555455554555545556
6333333333333333333333333333333333333356
6554555554555545555455554555555554555546
6533333333333333333333333333333333333336
6545555455554555545555455554555545555456
6333333333333333333333333333333333333356
6555554555545555455554555545555455554556
6111131111111111111111111111141111111116
6444333444444444444444444445040555555556
6555555555555555555555555555545555555556
6444444444444444444444444444445555555556
6444555555555555555555555555545555555556
6484444444444444444455555555545555544446
6444555555555555555555555555545555544446
6444444444444444444455555555545555444446
6666666666666666666666666666666666666666