.d=58
.t=200
6666666666666666666666666666666666666666
6555555555555555555555555555555555555556
6535655556003065533643346453460007000606
6343603056055065533643346544460666004606
6333605056055065555643346344360660066606
6345605056045065111643346443560007000606
6335605056054065000643346435560666004606
6534605056045760000643346555560660006606
6534605056055060000643346555560007000606
6523609056000060007644446555560666004606
6666666666666666666666666666660660066606
6300000000000000000000000000000000000006
6500000000000000000700000000000000070006
6066660535353535353535053535353535353506
6065550545454545454545054545454545454506
6065550535353535353535053535353535353506
6065550511111111111115051111111111111506
6065550000000000000000000000000000000006
6065550000000000000000000000000000000006
6065550000000000000000000000000000000006
6865550000000000000000000000000000000006
6666666666666666666666666666666666666666