.d=70
.t=200
6666666666666666666666666666666666666666
6335555555555555555355555555555555555556
6334554554455455455455455455455455455336
6334545555555555555555555555555556554336
6335455555435555555555333355555555555336
6334455555125553555555345555555555554336
6335455555414555555555333555555555554336
6335555555555555555555555555555555554336
6335555555555555555555555555555555554336
6335555555555555555555555555555555555336
6335111111111111111114555551111111115336
6334533335555555555645555565555555554336
6335544445555555555645555565555535555336
6334566665555554355655555565555363555336
6334555555555553435555534556655535554336
6335555544455553435553435555556465555586
6335545555555555534555435555555454555336
6334545554455555553555555555555555554336
6335455455455455454554554554554554545336
6333333333333333333333333333333333333336
6333333333333333333333333333333333333336
6666666666666666666666666666666666666666