.d=20
.t=400
6666666666666666666666666666666666666666
6355535535334351554355535535331545535536
6451153535555335555553155555555155553356
6552151555355155551535455355535153553556
6555533515555335513553515555455355355556
6311555553135555135535515315553135555436
6535455155535511553511111555555553553536
6515555533555551545355355535355535135556
6545553515531555355535535355515535555356
6555135555553555555353555435515553555536
6555535535555535535535535535515555115356
6351555555155553555555555553513554553536
6555535151535515553354535511555351553556
6555353515535515535353355155355515535356
6111555535355535555555535155345513511556
6553355535545353535535355535353555553536
6554555533555345111555355515353555355556
6355535355535535555535535355355155553386
6515531515535555355355153555535134355556
6515354555315535355535535535553155553556
6355535353535555453535335355333555555436
6666666666666666666666666666666666666666