.d=36
.t=400
6666666666666666666666666666666666666666
6553555555535555555555555555555355555556
6525555555555553555553535555555535555556
6555355535553555555555555355555555555356
6555553555555555553555555555355555555556
6355555555555555555555555555555555335556
6555555355555555355355555555555555553556
6555355555535555555555555555555355555556
6355555555555555555555555555535555555556
6555355555535555555535555555555355555556
6555555559055555905555539055555590555536
6555555530035555005355550055555500553556
6555555555555355555555355555555555355556
6555553555555555555555555555555555555556
6555555535555535555555553555555555555556
6355555555555555555555555555555555555556
6555555553555555553555555555555555555556
6555555555555555555553535555535555555556
6555555555555355553555555555535555555556
6555555355535553555555555355555535535556
6355535555555555535555555555555555353586
6666666666666666666666666666666666666666