.d=6
.t=100
6666666666666660000000000000000000000000
6000000000000060000000000000000000000000
6000000000000060000000000000000000000000
6900200030000060000000000000000000000000
6000000050000060000000000000000000000000
6000000000000060000000000000000000000000
6000000000000060000000000000000000000000
6000000000000060000000000000000000000000
6000000000000060000000000000000000000000
6000000000000860000000000000000000000000
6666666666666660000000000000000000000000
0000000000000000000000000000000000000000
0000000000000000000000000000000000000000
0000000000000000000000000000000000000000
0000000000000000000000000000000000000000
0000000000000000000000000000000000000000
0000000000000000000000000000000000000000
0000000000000000000000000000000000000000
0000000000000000000000000000000000000000
0000000000000000000000000000000000000000
0000000000000000000000000000000000000000
0000000000000000000000000000000000000000