.d=8
.t=400
6666666666666666666666666666666666666666
6255555555555555555555555555555555555556
6555555555555555555555555555555555555556
6555555555555555555555555555555555555556
6555555555555555555555555555555555555556
6555555555555555555555555555555555555556
6555557005555570055555700555557005555556
6555550005555500055555000555550005555556
6555550405555504055555040555550405555556
6555555555555555555555555555555555555556
6555555555555555555555555555555555555556
6555555555555555555555555555555555555556
6555557005555570055555700555557005555556
6555550005555500055555000555550005555556
6555550405555504055555040555550405555556
6555555555555555555555555555555555555556
6555555555555555555555555555555555555556
6555555555555555555555555555555555555556
6555555555555555555555555555555555555556
6555555555555555555555555555555555555556
6555555555555555555555555555555555555586
6666666666666666666666666666666666666666