.d=9
.t=400
6666666666666666666666666666666666666666
6111111111555344435555553555551111111116
6100000000555555555355555355550000000016
6104700000535555355535355553550000074016
6111111111555535555355555555551111111116
6100000000553555535555553555350000000016
6104700000555355555535555555550000074016
6111111111553555353555535555551111111116
6100000000555553555555355553550000000016
6134700000555535555535535535350000074016
6111111111533555353555555555551111111116
6100000000533535535555353533550000000016
6104700000555555555355355555550000074016
6111111111555535355553555555551111111116
6533555355553555555355555555535555553556
6555535533355555355555553555555555355556
6353535555355553553535535555355535553536
6555555355555355535555355555555355555556
6555353555355555555355355555555353558536
6325553535535535553555535555535555535556
6553535535555355555555555353555535355536
6666666666666666666666666666666666666666