.d=8
.t=300
6666666666666666666666666666666666666666
6545555535530555555535335505555550000556
6555455553555555355255555535055355555546
6535550705535535550555355311111111111116
6553500555533355553535555555555553550556
6111111111115555533555355555535555555586
6555355550553535555535535355550555553556
6555555553545553505555355555550553555556
6555555535555535555005353555554355553556
6505505555535555555575535555555555055536
6570555553555355353535550355555555550556
6555554535553553555555353555555000355556
6355535555555355553505555555535557553536
6555553555555555355553535555555555555556
6055355555355553555355555335535355555506
6555555555555555533535535553555555355536
6055355555505353555555355555505555555556
6355555553555555535555553535555355500056
6355035505335555355553555055355555550756
6555455355555355555555553535555553555556
6535555555555553555553555553553555553546
6666666666666666666666666666666666666666