.d=6
.t=300
6666666666666666666666666666666666666666
6553505555035555550555555050553555505456
6555545555555553555553535555555035555556
6805355557053505552505555355111111111116
6355553555000555553555355555350555550556
6111111111111553505550555505555505505506
6505055505535555555535555355055355035556
6555055555055055355555530555550555555506
6550350535035555300355055505055055553536
6053555455555355575555055555055554355056
6555055355505550355355350505111111111116
6350550550355555550555553555035555055506
6555355505535305535553555555555355550056
6111111111111355555555505553505550555506
6355550505055553550553553555355050055536
6553555505555511111111555555555555507556
6055505300055505555055505550555555555536
6055355505555555055553535055535505053556
6505755535555055553055555550535555555056
6453555355535553555555555355550535535456
6355535505550555535550555550555555353506
6666666666666666666666666666666666666666